111111111
1P100C101
101010101
1C0010001
111111111
