111111111
1P100C1C1
101010101
1C001E001
111111111
