111111111
1P100C1E1
101010111
1C00100C1
111111111
