111111111
1P100C1E1
101010101
1C001001
111111111
