111011111
1P100C1E1
101010101
1C0010001
111111111
